_AKP : Keyboard/Language Configuration
_CPU : Central Processor Unit Type
_CT2 : Centurbo II card present
_FDC : Disk Drive Type
_FLK : File Locking Extension
_FRB : Fast Ram Buffer
_FPU : Floating Point Unit Type
_IDT : International Date/Time Format
_INF : STEFIX Program
_JPD : Falcon030 JPEG Decoder by Brainstorm
_MCH : Machine Type
_MET : MetaDOS
_NET : GEMDOS Network Support
_OOL : Pool Fix
_PCI : PCI Bios Hardware
_SLM : SLM Driver
_SND : Sound Hardware
_SWI : Configuration Switches
_VDO : Video Type
_VID : Installed by CENTscreen
AB40 : Afterburner040 present
AFnt : AES Font Loader
AgKO : AusGuck RAMdisk
AHVR : VRAM
ALHP : Alman HP Deskjet Screendumper
ALIC : Alice
AmAN : A-MAN
AMC1 : Monitor Switchbox
AMC2 : PC Keyboard Driver Software
APGM : Sysgem by Andreas Pietsch
ARTS : Screen-Artist screensaver
AVmw : Virus Warning Program
AVOJ : Oliver Joppich's Anti Virus program
BASH : Bourne Again Shell
BCKW : BackWard
BIGS : Big Screen
BIOC : Pirosca
BGEM : BubbleGEM
BHLP : BubbleGEM help-server
BLNK : Screenblanker
BLOW : Blowup030
BSIM : Drive B Simulator
BUG1 : Bugaboo Debugger
CASE : Casing Type
CB2K : Claus Brod GEMDOS Bug Patch
CBCE : Claus Brod Critical Error Handler Patch
CBDF : Claus Brod Dabbel Feature
CBHD : Claus Brod HD Driver
CBHY : Claus Brod Hyper Format
CBIT : C'T Bus Interface Driver
CFIX : Console Fix
CFsl : Compo FSel
Cham : Chameleon
CHAM : Chameleon
CHNG : Changes
CISY : Cisystem
CJar : JarXXX Program
CKBD : Composed Character Deluxe Keyboard Driver
CKJR : Create Cookie Jar Program
CLCK : Mega-ST Hardware clock TSR Utilities
CLK1 : MEGA ST Clock Utility
CM16 : CyReL's M16 Versatile Installation Program
CNTS : CENTSCREEN
COLO : Colos Mono-Colour Converter
CPSL : Caps Lock Display
CRIT : Crypt-It
CSMD : CyReL's Serial Mouse Manager
CTCH : Master-Module Catch.mmx
CtCp : CapsLock Display
CTSF : CTS Bug Fix
CRAC : Protar HD Driver
CRIT : Crypt-It
cVDI : CyReL's M-16-1280 VDI Driver
CWCo : Compo FSel
DATE : Led Panel Date
DATL : TwiLight
DAWN : Before Dawn
DBFX : Diabalo Emulator patch fix for MiNT
DCdd : Double-Click Software Data Diet
DCSD : Calamus Screen Driver
DEPI : DeskPic
DHST : Document History Protocol
DIG2 : Digiplay by Emmanuel Jaccard
DKEY : Dead Key from Brainstorm
DNTR : DNT ramdisk
DPRS : Printer Buffer
DRIV : Drive Edit
DRRH : Wodan Keyboard Layout Program
DSSO : Sokrates Keyboard Driver
DYNL : Dynamic Link Library Driver
EdDI : EdDI by Sven&Wilfried Behne, BELA
ENVR : Environment manager
ENV$ : Desktop environment manager
EPro : Extendos Pro CD-ROM driver
ETM  : Entmauser
EXRA : Extra RAM Speeder Card Software
EXTD : TOS File Name Extender
FALT : Faltoff Screen() MEGA STE bufixer
FIX2 : FIX24 68030 -> 24 bits
FLTP : FlyTop
FLXD : Flexdisk
Fose : Font Selector
FOse : Fontselector
FrmD : Form_do_it
FSEL : Extended File Selector (e.g. Selectricø,Freedomø)
FSER : Fast Serial Interface Routines
FSMC : Advanced GDOS
FSmp : Martin Patzel File Selector
GABI : Gabrielle Serial Port Typewriter Emulator
GBel : GemBell
GDEV : GNU-C Device-Driver
GEMB : GE Soft HD Driver
GENV : GEM Environment Setter
GIGA : Giga Box ST Driver
gkCO : Calamus Thingy
GMNI : Gemini
GNUC : GNU-C Library
Gnva : Geneva Multi-tasking AES
GOff : Grow/Shrinkbox off
GSND : Gemsound
GSP1 : GEM Spooler
GULM : Gulam Shell
HABO : Haboo Harddisk Cache
HAMM : Melody Maker Software
HBFS : BoxKite File Selector
HcP6 : NEC P6 Hardcopy Driver
HDDR : HD Driver
HDJR : Hushi HD Interface Driver
HDPR : HD Protect
HDST : Eickmann HD Driver
HDSW : High Density Switcher
HFIX : Handle Bug Fix
HIDS : High Density Disk Driver
HMDU : HM2 System Memory Dump
HMOC : H!nisch Modula Object Cache
HMRD : H!nisch Modula Run-Time Debugger
HMRS : HM2 Run-Time System
HPHC : HP Deskjet Hardcopy
HPLJ : HP Laserjet Emulator
HSnd : CrazySounds
HSND : CrazySounds
HWAM : Cookie Jar creator program
IBMP : Norwegian->IBM Printer Converter
ICFS : Iconify Server
IDSK : Icon Desk
IMAC : Bootsector Guardian
IMNE : Imagine graphics card
INSJ : Cookie Jar installer/extendor program
INXR : Index generator
iPRN : iPRN
JAM1 : Butler James
JCLK : Joy Clocky
JCNB : JCN Bootselector
JCNC : JCN Multi Accessory
JCNH : Hardcopy Program
JCNT : Cocteau Word Processor
JFTP : SCSI driver for generic tape devices
JINX : Jinx
JMLS : JML Snapshot
JSHD : High Density Control Program
JUST : Justify
KbEv : MM2 Keyboard Handling Module
KIDI : RAMdisk
KGTF : Tos Fix
KyMp : Keyboard Macro & Remapping Utility
LALA : Albolala BellHook Sample Player
LAWC : Look-Ahead-Write-Cache
LEDP : LED-Panel
Lity : Liberty
LLCR : Logilex 1st Lock
LOGB : LogBuch
LPCD : Carrier Detector
LPJM : Joy Mouse
LP/2 : Malloc 2 Gemdos Vector
LTMF : Let 'em Fly
macc : Maccel 3
MADD : Add mem for TT
MagC : Magic Dials Configuration program
MagX : Mag!X
MAST : Master
MaTC : Matrix True Colour Graphics Card
MCL_ : MiNT control
McSn : MacSound
MCWR : Microwire DMA sound interface
MDIA : Multi-Dialog
MDSa : Medical Design Software's Serial Fix
MFAC : Multi Accessory
MFNT : Fontloader
MGEM : MultiGEM
MgMc : MagiCMac
MID3 : MIDINET3
MIMA : MIDI Manager
MiNT : Mint/MultiTOS
MJAF : Martin Jahr
MKHC : Hardcopy Fixer
MkJr : Cookie Jar creator program
MMAC : Magic Mouse Accelerator
MM_2 : Midimaze 2
MMUT : Midi Maze II Utility
MNAM : MagiCMac Name cookie
MOGR : GEMRAM
MPRO : Magic Pro Config CPX
MRAM : More RAM
MSPD : Mouse Speeder
MSPO : Magic Spooler
mstx : Mouse Tricks
MUPF : Mupfel
N203 : Multi Accessory
NCLN : NiceLine
NERV : No etv_critic_alert
NETS : PAM Novell Software
NFnt : Neodesk Font Loader
NLdr : Neodesk Loader
nAES : Naes, the AES for MiNT
noCF : noSystem
NOR5 : Norwegian Keyboard Driver
NOVA : NOVA graphics card
NO7P : Norwegian->7 bit printer converter
NSC1 : N_Syscom accessory
NTK4 : NTK4 Falcon MOD player
NUL> : System startup utility
NVDI : NVDI
Nspd : Nemesis speeder
OFLS : Check Open Files
OPMM : Open Helper
OSBL : Screen Blaster
OSTT : OverScan TT
OV24 : OverScan Hardcopy Driver 24 pins
OVDJ : OverScan Hardcopy Driver HP Deskjet
OVEP : OverScan Hardcopy Driver 9 pins
OVER : AutoSwitch OverScan Hardware Driver
OVFS : OverScan Fileselector Patch
OVIM : OverScan Hardcopy Driver
OVLS : OverScan DMC Laserbrain Patch
OVRD : OverScan RamDisk
OVUT : OverScan Screen Blanker
OVWI : OverScan Window-Size Patch
PAMN : PAM Network Driver
PBUG : PeaceBug
PDOS : PowerDOS
PFIX : PTSIN Fix
Pinp : Parallel Input Port Driver
PKSH : PKS-Shell
PlFn : POLFONT Polish National Character set installed
PMMU : PMMU reprogrammed
POIS : Poison!
POWM : PowerMouse
PRCS : CopySTar
PRDS : Peter Rohde Disk Speeder
PRN! : WandelSZ
PRO5 : Resident virus check/kill/protect program
PROT : Protos Screen Utility
PRTD : Print to Disk V1.10
PRTO : ST Tools
prtr : Atari->IBM Printer Converter
PRTR : Protar HD Driver
PSSG : Paint Shop Hardcopy vector
PTOS : ROMRAM: copy TOS in TT-RAM
QIKM : Quick Mouse
QMAC : Quick Mouse Driver Accessory
QMCP : Chemplot Quick Mouse Driver
QST2 : Quick ST 2
QST3 : Quick ST 3
QUAN : QuanTOS Multiutility
RAIL : Rail Manager
RDCT : part of NVDI et4k (redirect)
RFLX : AutoSwitch Driver for Reflex Graphics Card
RFUS : Rufus terminal program;
RSLT : GengTEC VGA Monochrome/16 Colour Driver
RSpd : RS_SPEED (Serial Fix)
RSVE : RSVE Patch
RSVF : RS232 Version Fast (HSMODEM)
RTOB : Optobell
RTKC : Keyclick
RWIN : RootWindow
SAM  : System Audio Manager
SBKM : Ring Recognition in Modem Routs
SBTE : Terminal Program
SBTS : Trap Spy
SCAH : Speed Cache
SCRN : Screen Scroll
SCRS : Screen Blanker
SCRW : Screen Watch
SCSI : SCSI Driver
SCSV : Line Art Screensaver
S_DR : CDROM SCSI driver
SDsk : Softdisk
SDWN : ScreenDown
SELC : C-Lab File selector
SENV : Set Environment
SFA^ : Fontloader system
SFIX : Serial Port Fix
SFMN : SafeMenu
SMAL : Small AES Icon fonts
SMAU : Set Mouse Accessory
SMon : SysMon
SM00 : SOTA Printer Spooler
SM01 : ReProK Office Management DUO
SM02 : ReProK International EM-NET II
SMTT : SM-124 Emulator
SNAP : That's Snap Accessory
SPCK : RAMdisk for SPC Modula
SPEE : Mouse Speeder
SPEX : Steve's Printing Exzessory
Spol : Flexible Printer Spooler
SSND : Petra
STAT : StaTOS
ST-C : Cache Program
STEW : Stewart
STiK : ST Internet Kit
STMS : ST Magazine Screendump
STRX : SAT-Trax Antenna driver
SVGA : Super VGA Emulator
SWAP : Outside
SYMB : Symbol driver
SYNL : Dynamic Link Library Driver
SYNT : Syntex
SysE : System Editor
Syso : ST Sysop
SZ_M : Dynamic Mouse Speeder
TASS : Turbo Assembler
TCFS : Turbo C File Selector
TCRB : Turbo Cache
Tenv : Environment Set Program for Terminal
TFIX : TOS 1.04 fix
THNX : Thinx
TIM3 : Time Driver
TIM5 : Time Driver plus Screen Blanker
TIME : Led Panel Time
TK40 : Afterburner040 Toolkit-driver
Tmon : TempleMon
TMon : TempleMon
TOpW : Top Manager Watcher
TPat : Tos Patch
TRAK : Track Speed
TraP : TraPatch 
TSEN : TSE Net
TSWP : TonySoft Write Protection
TTTF : Thirty Two to Twenty Four
TWFS : That's Write File Selector Accessory
Typ1 : Daisywheel accessory
UFSL : Extended Universal Font Selector
UIS3 : Universal Item Selector 3
UKB1 : Fastload
UKB3 : Fastload plus MIDI Through
UN*X : Unixname (/->\ Converter)
USHD : Diskus HD driver
USRS : Romspeed
USPK : Hard Disk Auto Parker
UTRK : Ultimate Tracker
VECS : Vecshow
VeiL : Turbo Veille
VDLY :Videlity - screen enhancer
VFIX : VDIFix
VFNT : VdiFont
VI-2 : Videl Inside
VIRA : Virus Alarm
VGAS : VGA Simulator
VMEM : Virtual Memory
VRAM : Virtual Memory Management for the TT
VREP : Vector Guard
VSco : Virus Scope
VSCR : Structure of Virtual Screens
VSTM : MIDI Transfer
WARP : Warp 9
WBrd : Bird's Wing
WDOG : Watchdog
WEGA : WEGA Libraries
WFSL : Window File Selector
WICO : WinCom
WINX : WINX
WINZ : L!ftscho!/WinzRAM RAMdisk
WPRO : Write Protect
WrAp : WarpMouse
XBTN : Mouse speeder routine from XBOOT
XDsk : X-DISK ramdisk
XFS1 : Master Module for extended TOS File System
xFSL : Extended Font Selector
XFRB : Extended Fast Ram Buffer
XHDI : XHDI driver
XKBD : Extended Keyboard
XMMU : Afterburner040 PMMU-driver
XMuz : Ultra Player
xNet : xNet-ST
xRmt : XREMOTE
XSSI : Extended Screen Saver Information
xUFC : Extended Universal Font Selector Configuration Program
XWin : Extended Windows moudle
zCAC : 680x0 Cache Control CPX
zDCF : DCF-Time receiver
_AFM : Audio Fun Machine
_FSR : Patch program for serial (TOS 4.00->4.04)
_PWR : Power Management unit
_T30 : KAOS TOS
‰FSC : Falcon Screen
$00AA006E : MACCELL Cookie

